|******************************************************************************|
|                                                                           E  |
|                                                                              |
|      E                                                                       |
|                                                                              |
|                                                                              |
|                                                                              |
|                                                                              |
|                                                                              |
|                                                                              |
|                                                                              |
|                                                                              |
|                                                                              |
|                                                                              |
|                                                                              |
|                                                                     E        |
|                                                                              |
|                                                                              |
|                                                                              |
|                                                                              |
|                                                                              |
|  E                                                                           |
|                                                                              |
|                                                                              |
|******************************************************************************|